Ashanti - Foolish
P. Diddy Featuring Usher & Loon - I Need A Girl (Part One)
Fat Joe Featuring Ashanti - What's Luv?
Usher - U Don't Have To Call
Vanessa Carlton - A Thousand Miles
Michelle Branch - All You Wanted
Puddle Of Mudd - Blurry
Jimmy Eat World - The Middle
Eminem - Without Me
P!nk - Don't Let Me Get Me
Nelly - Hot In Herre
Mary J. Blige Featuring Ja Rule - Rainy Dayz
Truth Hurts Featuring Rakim - Addictive
Shakira - Underneath Your Clothes
Busta Rhymes Featuring P. Diddy & Pharrell - Pass The Courvoisier Part II
No Doubt - Hella Good
Default - Wasting My Time
Goo Goo Dolls - Here Is Gone
Jennifer Lopez Featuring Ja Rule - Ain't It Funny
Linkin Park - In The End
The Calling - Wherever You Will Go
Cam'Ron Featuring Juelz Santana - Oh Boy
Nickelback - How You Remind Me
Musiq - halfcrazy
*NSYNC Featuring Nelly - Girlfriend
Jennifer Lopez Featuring Nas - I'm Gonna Be Alright
Ja Rule Featuring Charli "Chuck" Baltimore - Down A** Chick
Tweet - Oops (Oh My)
Aaliyah - More Than A Woman
Alan Jackson - Drive (For Daddy Gene)
Enrique Iglesias - Escape
Avant - Makin' Good Love
Celine Dion - A New Day Has Come
Sheryl Crow - Soak Up The Sun
Steve Azar - I Don't Have To Be Me ('til Monday)
George Strait - Living And Living Well
Brandy - Full Moon
Toby Keith - My List
Tommy Shane Steiner - What If She's An Angel
Ludacris Featuring Sleepy Brown - Saturday (Oooh! Ooooh!)
B2K - Uh Huh
Jaheim Featuring Next - Anything
Nas - One Mic
B2K - Gots Ta Be
Nickelback - Too Bad
Emerson Drive - I Should Be Sleeping
Faith Evans - I Love You
Chad Kroeger Featuring Josey Scott - Hero
Big Tymers - Still Fly
Brad Paisley - I'm Gonna Miss Her (The Fishin' Song)
Nappy Roots - Awnaw
Kylie Minogue - Can't Get You Out Of My Head
Naughty By Nature Featuring 3LW - Feels Good (Don't Worry Bout A Thing)
Phil Vassar - That's When I Love You
Dirty Vegas - Days Go By
Ying Yang Twins - Say I Yi Yi
Donell Jones - You Know That I Love You
Carolyn Dawn Johnson - I Don't Want You To Go
Paulina Rubio - Don't Say Goodbye
Ruff Endz - Someone To Love You
Travis Tritt - Modern Day Bonnie And Clyde
Craig David - Walking Away
Lonestar - Not A Day Goes By
Joe - What If A Woman
Gary Allan - The One
India.Arie - Video
Kenny Chesney - Young
P.O.D. - Youth Of The Nation
Staind - For You
Martina McBride - Blessed
System Of A Down - Toxicity
Korn - Here To Stay
Alanis Morissette - Hands Clean
Pilar Montenegro - Quitame Ese Hombre
Brooks & Dunn - My Heart Is Lost To You
Puddle Of Mudd - Drift & Die
Alicia Keys - How Come You Don't Call Me
Rascal Flatts - I'm Movin' On
Chris Cagle - I Breathe In, I Breathe Out
Maxwell - This Woman's Work
N.O.R.E. - Nothin'
Angie Stone - Wish I Didn't Miss You
Khia Featuring DSD - My Neck, My Back
Beanie Sigel & Freeway - Roc The Mic
Scarface Featuring Jay-Z & Beanie Sigel - Guess Who's Back
Hoobastank - Crawling In The Dark
Tim McGraw - The Cowboy In Me
Mario - Just A Friend 2002
Remy Shand - Take A Message
Kevin Denney - That's Just Jessie
Tanto Metro & Devonte - Give It To Her
Amanda Perez - Never
Lil Bow Wow - Take Ya Home
Brandy - What About Us?
Dixie Chicks - Some Days You Gotta Dance
Jade Anderson - Sugarhigh
Sean Paul - Gimme The Light
Clipse - Grindin'
Britney Spears - Overprotected
B Rich - Whoa Now
